0,0,0,7,7,7,7,7,7,7,7,7,0,0,0,7,7,7,7,7,7,7,7,7,0,0,0,0,0,0,0,0,0,0,0,0,0,0,0,0,0,0,0,0,0,0,0,0,0,0
0,0,7,8,8,8,8,8,8,8,8,8,7,0,7,8,8,8,8,8,8,8,8,8,7,0,0,0,0,0,0,0,0,0,0,0,0,0,0,0,0,0,0,0,0,0,0,0,0,0
0,0,7,8,8,8,8,8,8,8,8,8,8,4,8,8,8,8,8,8,8,8,8,8,7,0,0,0,0,0,0,0,0,0,0,0,0,0,0,0,0,0,0,0,0,0,0,0,0,0
0,0,7,8,8,8,8,8,8,8,8,8,8,4,8,8,8,8,8,8,8,8,8,8,7,0,0,0,0,0,0,0,0,0,0,0,0,0,0,0,0,0,0,0,0,0,0,0,0,0
0,0,7,8,8,8,8,8,8,8,8,8,8,4,8,8,8,8,8,8,8,8,8,8,7,0,0,0,0,0,0,0,0,0,0,0,0,0,0,0,0,0,0,0,0,0,0,0,0,0
0,0,7,8,8,8,8,8,8,8,8,8,7,0,7,8,8,8,8,8,8,8,8,8,7,0,0,0,0,0,0,0,0,0,0,0,0,0,0,0,0,0,0,0,0,0,0,0,0,0
0,0,0,7,7,7,7,7,7,7,7,7,0,0,0,7,7,7,8,8,8,7,7,7,0,0,0,0,0,0,0,0,0,0,0,0,0,0,0,0,0,0,0,0,0,0,0,0,0,0
0,0,0,0,0,0,4,4,4,0,0,0,0,0,0,0,0,0,4,4,4,0,0,0,0,0,0,0,0,0,0,0,0,0,0,0,0,0,0,0,0,0,0,0,0,0,0,0,0,0
0,0,0,7,7,7,8,8,8,7,7,7,0,0,0,7,7,7,8,8,8,7,7,7,0,0,0,0,0,0,0,0,0,0,0,0,0,0,0,0,0,0,0,0,0,0,0,0,0,0
0,0,7,8,8,8,8,8,8,8,8,8,7,0,7,8,8,8,8,8,8,8,8,8,7,0,0,0,0,0,0,0,0,0,0,0,0,0,0,0,0,0,0,0,0,0,0,0,0,0
0,0,7,8,8,8,8,8,8,8,8,8,8,4,8,8,8,8,8,8,8,8,8,8,7,0,0,0,0,0,0,0,0,0,0,0,0,0,0,0,0,0,0,0,0,0,0,0,0,0
0,0,7,8,8,8,8,8,8,8,8,8,8,4,8,8,8,8,8,8,8,8,8,8,7,0,0,0,0,0,0,0,0,0,0,0,0,0,0,0,0,0,0,0,0,0,0,0,0,0
0,0,7,8,8,8,8,8,8,8,8,8,8,4,8,8,8,8,8,8,8,8,8,8,7,0,0,0,0,0,0,0,0,0,0,0,0,0,0,0,0,0,0,0,0,0,0,0,0,0
0,0,7,8,8,8,8,8,8,8,8,8,7,0,7,8,8,8,8,8,8,8,8,8,7,0,0,0,0,0,0,0,0,0,0,0,0,0,0,0,0,0,0,0,0,0,0,0,0,0
0,0,7,8,8,8,8,8,8,8,8,8,7,0,0,7,7,7,7,7,7,7,7,7,0,0,0,0,0,0,0,0,0,0,0,0,0,0,0,0,0,0,0,0,0,0,0,0,0,0
0,0,7,8,8,8,8,8,8,8,8,8,7,0,0,0,0,0,4,4,4,0,0,0,0,0,0,0,0,0,0,0,0,0,0,0,0,0,0,0,0,0,0,0,0,0,0,0,0,0
0,0,7,8,8,8,8,8,8,8,8,8,7,0,0,7,7,7,7,7,7,7,7,7,0,0,0,7,7,7,7,7,7,7,7,0,0,0,0,0,0,0,0,0,0,0,0,0,0,0
0,0,7,8,8,8,8,8,8,8,8,8,7,0,7,8,8,8,8,8,8,8,8,8,7,0,7,8,8,8,8,8,8,8,8,7,0,0,0,0,0,0,0,0,0,0,0,0,0,0
0,0,7,8,8,8,8,8,8,8,8,8,7,0,7,8,8,8,8,8,8,8,8,8,8,4,8,8,8,8,8,8,8,8,8,8,4,7,7,f,f,g,0,0,0,0,0,0,0,0
0,0,7,8,8,8,8,8,8,8,8,8,7,0,7,8,8,8,8,8,8,8,8,8,8,4,8,8,8,8,8,8,8,8,8,8,4,8,8,8,8,f,0,0,0,0,0,0,0,0
0,0,7,8,8,8,8,8,8,8,8,8,7,0,7,8,8,8,8,8,8,8,8,8,8,4,8,8,8,8,8,8,8,8,8,8,4,7,7,7,8,7,0,0,0,0,0,0,0,0
0,0,7,8,8,8,8,8,8,8,8,8,7,0,7,8,8,8,8,8,8,8,8,8,7,0,7,8,8,8,8,8,8,8,8,7,0,0,0,7,8,7,0,0,0,0,0,0,0,0
0,0,0,7,7,7,8,8,8,7,7,7,0,0,0,7,7,7,7,7,7,7,7,7,0,0,0,7,7,7,7,7,7,7,7,0,0,0,7,7,8,7,7,0,0,0,0,0,0,0
0,0,0,0,0,0,4,4,4,0,0,0,0,0,0,0,0,0,4,4,4,0,0,0,0,0,0,0,0,0,0,0,0,0,0,0,7,7,8,8,8,8,8,7,g,0,0,0,0,0
0,0,0,7,7,7,8,8,8,7,7,7,0,0,0,7,7,7,7,7,7,7,7,7,0,0,0,0,0,0,0,0,0,0,0,f,8,8,8,8,8,8,8,8,8,f,0,0,0,0
0,0,7,8,8,8,8,8,8,8,8,8,7,0,7,8,8,8,8,8,8,8,8,8,7,0,0,0,0,0,0,0,0,0,7,8,8,8,8,8,8,8,8,8,8,8,h,0,0,0
0,0,8,8,8,8,8,8,8,8,8,8,8,4,8,8,8,8,8,8,8,8,8,8,7,0,0,m,m,m,m,m,0,0,7,8,8,t,t,8,8,t,t,t,t,8,7,0,0,0
0,0,8,8,8,8,8,8,8,8,8,8,8,4,8,8,8,8,8,8,8,8,8,8,7,0,7,7,7,7,7,7,t,8,8,8,8,t,t,8,8,t,t,t,t,8,7,0,0,0
0,0,8,8,8,8,8,8,8,8,8,8,8,4,8,8,8,8,8,8,8,8,8,8,7,4,8,7,7,7,7,7,t,8,8,8,8,8,8,8,8,8,8,8,8,8,8,t,0,0
0,0,7,8,8,8,8,8,8,8,8,8,7,0,8,8,8,8,8,8,8,8,8,8,7,4,8,7,7,7,7,7,t,8,8,8,8,8,8,8,8,8,8,8,8,8,8,t,0,0
0,0,0,7,7,7,7,7,7,7,7,7,0,0,8,8,8,8,8,8,8,8,8,8,7,4,8,7,7,p,p,p,p,8,8,8,8,t,t,8,8,t,t,t,t,8,8,t,0,0
0,0,0,0,0,0,0,0,0,0,0,0,0,0,8,8,8,8,8,8,8,8,8,8,7,0,7,7,7,7,7,7,p,8,8,8,8,t,t,8,8,t,t,t,t,8,8,7,0,0
0,0,0,0,0,0,0,0,0,0,0,0,0,0,7,8,8,8,8,8,8,8,8,8,7,0,8,7,7,p,p,7,p,8,8,8,8,8,8,8,8,8,8,8,8,8,8,r,0,0
0,0,0,0,0,0,0,0,0,0,0,0,0,0,0,7,7,7,7,7,7,7,7,7,0,0,8,7,7,p,b,7,p,8,8,8,8,7,8,r,8,7,8,7,8,7,8,q,0,0
0,0,0,0,0,0,0,0,0,0,0,0,0,0,0,0,0,0,0,0,0,0,0,0,0,0,8,7,7,p,p,7,p,8,8,8,8,8,r,q,r,8,7,r,q,r,7,r,0,0
0,0,0,0,0,0,0,0,0,0,0,0,0,0,0,0,0,0,0,0,0,0,0,0,0,0,7,7,7,7,7,7,q,8,8,8,8,7,8,r,8,7,8,7,r,7,8,7,0,0
0,0,0,0,0,0,0,0,0,0,0,0,0,0,0,0,0,0,0,0,0,0,0,0,0,0,0,q,q,q,q,q,q,8,8,8,8,8,7,8,7,8,7,8,7,8,7,r,0,0
0,0,0,0,0,0,0,0,0,0,0,0,0,0,0,0,0,0,0,0,0,6,6,6,6,0,7,8,8,8,8,8,8,8,8,8,8,7,r,q,r,7,r,q,r,7,8,q,0,0
0,0,0,0,0,0,0,0,0,0,0,0,0,0,0,0,0,0,0,0,0,6,6,6,6,4,7,8,8,8,8,8,8,8,8,8,8,8,7,8,7,8,7,8,7,8,7,r,0,0
0,0,0,0,0,0,0,0,0,0,0,0,0,0,0,0,0,0,0,0,0,6,6,6,6,0,7,7,8,r,q,r,8,8,8,8,8,7,r,q,r,7,r,q,r,7,7,7,0,0
0,0,0,0,0,0,0,0,0,0,0,0,0,0,0,0,0,0,0,0,0,6,6,6,6,0,0,7,7,r,q,r,7,7,7,8,8,8,r,q,r,7,r,q,r,8,7,0,0,0
0,0,0,0,0,0,0,0,0,0,0,0,0,0,0,0,0,0,0,0,0,0,0,0,4,0,0,0,0,0,0,0,0,0,r,8,8,8,),0,0,0,0,0,0,4,0,0,0,0
0,0,0,0,0,0,0,0,0,0,0,0,0,0,0,0,0,0,0,7,5,5,5,7,7,7,f,f,7,7,7,7,0,0,q,8,8,8,),0,0,7,5,5,7,7,7,0,0,0
0,0,0,0,0,0,0,0,0,0,0,0,0,0,0,0,0,0,7,7,8,8,8,8,8,8,8,8,8,8,8,7,7,0,r,8,8,8,),0,7,8,8,8,8,8,8,t,0,0
0,0,0,0,0,0,0,0,0,0,0,0,0,0,0,0,0,0,7,8,8,8,8,8,8,8,8,8,8,8,8,8,7,4,8,8,8,8,8,4,8,8,t,t,t,8,8,t,0,0
0,0,0,0,0,0,0,0,0,0,0,0,0,0,0,0,0,0,7,8,8,8,8,8,8,8,8,8,8,8,8,8,7,0,7,7,8,7,7,0,7,8,8,8,8,8,8,t,0,0
0,0,0,0,0,0,0,0,0,0,0,0,0,0,0,0,0,0,7,7,o,8,o,8,o,8,o,8,o,8,o,7,7,0,0,7,7,7,0,0,0,7,7,7,7,7,7,0,0,0
0,0,0,0,0,0,0,0,0,0,0,0,0,0,0,0,0,0,0,s,o,s,o,s,o,s,o,s,o,s,o,s,0,0,0,0,0,0,0,0,0,0,7,0,7,0,7,0,0,0
0,0,0,0,0,0,0,0,0,0,0,0,0,0,0,0,0,0,0,0,0,0,0,0,0,0,0,0,0,0,0,0,0,0,0,0,0,0,0,0,0,0,0,0,0,0,0,0,0,0
0,0,0,0,0,0,0,0,0,0,0,0,0,0,0,0,0,0,0,0,0,0,0,0,0,0,0,0,0,0,0,0,0,0,0,0,0,0,0,0,0,0,0,0,0,0,0,0,0,0
,,,,,,,,,,,,,,,,,,,,,,,,,,,,,,,,,,,,,,,,,,,,,,,,,
,,,,,,,,,,,,,,,,,,,,,,,,,,,,,,,,,,,,,,,,,,,,,,,,,
,0,#000000,,,a,#cfe2f3,,,e,#b6d7a8,,,k,#fff2cc,,,q,#7f5100,,,u,#ead1dc,,,!,#f4cccc,,,&,#d9d2e9,,,,],#c9daf8,,,,,,,,,,,,,,
,1,#1A1A1A,,,b,#9fc5e8,,,f,#93c47d,,,l,#ffe599,,,r,#7f3c00,,,v,#d5a6bd,,,@,#ea9999,,,*,#b4a7d6,,,,{,#a4c2f4,,,,,,,,,,,,,,
,2,#2D2D2D,,,c,#6fa8dc,,,g,#6aa84f,,,m,#ffd966,,,s,#b69675,,,w,#c27ba0,,,#,#e06666,,,(,#8e7cc3,,,,},#6d9eeb,,,,,,,,,,,,,,
,3,#424242,,,d,#3d85c6,,,h,#38761d,,,n,#f1c232,,,t,#caa472,,,x,#a64d79,,,$,#cc0000,,,),#674ea7,,,,\,#3c78d8,,,,,,,,,,,,,,
,4,#656565,,,,,,,i,#274e13,,,o,#bf9000,,,,,,,y,#741b47,,,%,#990000,,,-,#351c75,,,,|,#1155cc,,,,,,,,,,,,,,
,5,#878787,,,,,,,j,#18330b,,,p,#7f6000,,,,,,,z,#4c1130,,,^,#660000,,,[,#20124d,,,,"""",#1c4587,,,,,,,,,,,,,,
,6,#C1C1C1,,,,,,,,,,,,,,,,,,,,,,,,,,,,,,,,,,,,,,,,,,,,,,,
,7,#D3D3D3,,,,,,,,,,,,,,,,,,,,,,,,,,,,,,,,,,,,,,,,,,,,,,,
,8,#E1E1E1,,,,,,,,,,,,,,,,,,,,,,,,,,,,,,,,,,,,,,,,,,,,,,,
,9,#FFFFFF,,,,,,,,,,,,,,,,,,,,,,,,,,,,,,,,,,,,,,,,,,,,,,,